40 23
0 0
0 0 0 0 0 0 0 0 0 0 0 0 0 0 0 0 0 0 0 0 0 0 0 0 0 0 0 0 0 0 0 0 0 0 0 0 0 0 0 0
0 6 2 2 2 2 2 2 2 2 2 2 2 2 2 2 2 2 2 2 2 2 2 2 2 2 2 2 2 2 2 2 2 2 2 2 2 2 7 0
0 3 1 1 1 1 1 1 1 1 1 20 1 1 1 1 1 1 1 1 18 19 1 1 1 1 1 1 1 1 1 1 1 1 1 1 1 1 3 0
0 3 20 1 6 2 2 2 2 7 1 21 1 6 2 2 2 2 7 1 1 1 1 6 2 2 7 1 20 1 6 2 2 2 2 7 1 20 3 0
0 3 21 1 4 2 2 2 2 5 1 1 1 4 2 2 2 2 5 1 1 12 2 10 2 2 5 1 21 1 4 2 2 2 2 5 1 21 3 0
0 3 1 1 1 1 1 1 1 1 14 1 14 0 0 0 0 0 0 14 1 1 1 1 1 6 7 1 1 14 1 1 1 1 1 1 1 1 3 0
0 3 22 16 23 1 22 16 23 1 3 1 3 0 64 0 66 0 0 3 1 22 16 23 1 3 3 20 1 3 1 22 23 1 20 1 20 1 3 0
0 3 27 16 25 1 24 16 25 1 3 1 3 0 0 65 0 67 0 3 1 21 1 21 1 3 3 21 1 3 1 24 25 1 21 1 24 23 3 0
0 3 17 1 1 1 1 1 1 1 3 1 3 0 0 0 0 0 0 3 1 1 1 1 1 3 3 1 1 3 1 1 1 1 1 1 1 17 3 0
0 15 21 1 6 2 2 2 2 7 3 1 3 6 2 2 2 2 7 3 1 20 1 20 1 3 3 1 20 1 6 2 2 2 2 7 1 21 15 0
1 1 1 1 4 2 2 2 2 5 3 1 3 4 2 2 2 2 5 3 1 24 16 25 1 3 3 1 17 1 4 2 2 2 2 5 1 1 1 1
0 14 1 20 1 1 1 1 1 1 3 1 3 0 0 0 0 0 0 3 1 1 1 1 1 3 3 1 17 1 1 1 1 1 1 1 3 1 14 0
0 3 1 21 1 20 1 22 23 1 3 1 3 0 0 0 0 0 0 3 1 22 16 23 1 3 3 1 17 1 18 16 16 16 19 1 3 1 3 0
0 3 1 1 1 17 1 17 17 1 3 1 3 0 0 0 0 0 0 3 1 17 1 17 1 3 3 1 17 1 1 1 1 1 1 1 3 1 3 0
0 3 1 18 16 28 16 28 25 1 3 1 3 0 0 0 0 0 0 3 1 21 1 21 1 3 3 1 24 16 16 16 16 16 19 1 3 1 3 0
0 3 1 1 1 1 1 1 1 1 15 1 15 0 0 0 0 0 0 15 1 1 1 1 1 4 5 1 1 1 1 1 1 1 1 1 15 1 3 0
0 3 20 1 6 2 2 2 2 7 1 1 1 6 2 2 2 2 7 20 1 6 2 2 2 2 2 2 7 1 6 2 2 2 2 7 20 1 3 0
0 3 21 1 4 2 2 2 2 5 1 20 1 4 2 2 2 2 5 21 1 4 2 2 2 2 2 2 5 1 4 2 2 2 2 5 21 1 3 0
0 3 1 1 1 1 1 1 1 1 1 21 1 1 1 1 1 1 1 1 1 1 1 1 1 1 1 1 1 1 1 1 1 1 1 1 1 1 3 0
0 4 2 2 2 2 2 2 2 2 2 2 2 2 2 2 2 2 2 2 2 2 2 2 2 2 2 2 2 2 2 2 2 2 2 2 2 2 5 0
0 0 0 0 0 0 0 0 0 0 0 0 0 0 0 0 0 0 0 0 0 0 0 0 0 0 0 0 0 0 0 0 0 0 0 0 0 0 0 0
0 0 0 0 0 0 0 0 0 0 0 0 0 0 0 0 0 0 0 0 0 0 0 0 0 0 0 0 0 0 0 0 0 0 0 0 0 0 0 0
0 0 0 0 0 0 0 0 0 0 0 0 0 0 0 0 0 0 0 0 0 0 0 0 0 0 0 0 0 0 0 0 0 0 0 0 0 0 0 0