40 23
0 0
0 0 0 0 0 0 0 0 0 0 0 0 0 0 0 0 0 0 0 0 0 0 0 0 0 0 0 0 0 0 0 0 0 0 0 0 0 0 0 0
0 10 2 2 2 2 2 2 2 2 2 2 2 2 2 2 2 2 2 2 2 2 2 2 2 2 2 2 2 2 2 2 2 2 2 2 2 2 8 0
0 3 1 1 1 1 1 1 1 1 1 0 1 1 1 1 1 1 1 1 0 0 1 1 1 1 1 1 1 1 1 1 1 1 1 1 1 1 3 0
0 3 0 1 10 2 2 2 2 8 1 0 1 10 2 2 2 2 8 1 1 1 1 6 2 2 8 1 0 1 10 2 2 2 2 8 1 0 3 0
0 3 0 1 11 2 2 2 2 9 1 1 1 11 2 2 2 2 9 1 1 12 2 18 2 2 9 1 0 1 11 2 2 2 2 9 1 0 3 0
0 3 1 1 1 1 1 1 1 1 14 1 14 0 0 0 0 0 0 14 1 1 1 1 1 6 7 1 1 14 1 1 1 1 1 1 1 1 3 0
0 3 0 0 0 1 0 0 0 1 3 1 3 0 64 0 66 0 0 3 1 0 0 0 1 3 3 0 1 3 1 0 0 1 0 1 0 1 3 0
0 3 0 0 0 1 0 0 0 1 3 1 3 0 0 65 0 67 0 3 1 0 1 0 1 3 3 0 1 3 1 0 0 1 0 1 0 0 3 0
0 3 0 1 1 1 1 1 1 1 3 1 3 0 0 0 0 0 0 3 1 1 1 1 1 3 3 1 1 3 1 1 1 1 1 1 1 0 3 0
0 15 0 1 10 2 2 2 2 8 3 1 3 10 2 2 2 2 8 3 1 0 1 0 1 3 3 1 0 1 10 2 2 2 2 8 1 0 15 0
1 1 1 1 11 2 2 2 2 9 3 1 3 11 2 2 2 2 9 3 1 0 0 0 1 3 3 1 0 1 11 2 2 2 2 9 1 1 1 1
0 14 1 0 1 1 1 1 1 1 3 1 3 0 0 0 0 0 0 3 1 1 1 1 1 3 3 1 0 1 1 1 1 1 1 1 3 1 14 0
0 3 1 0 1 0 1 0 0 1 3 1 3 0 0 0 0 0 0 3 1 0 0 0 1 3 3 1 0 1 0 0 0 0 0 1 3 1 3 0
0 3 1 1 1 0 1 0 0 1 3 1 3 0 0 0 0 0 0 3 1 0 1 0 1 3 3 1 0 1 1 1 1 1 1 1 3 1 3 0
0 3 1 0 0 0 0 0 0 1 3 1 3 0 0 0 0 0 0 3 1 0 1 0 1 3 3 1 0 0 0 0 0 0 0 1 3 1 3 0
0 3 1 1 1 1 1 1 1 1 15 1 15 0 0 0 0 0 0 15 1 1 1 1 1 4 5 1 1 1 1 1 1 1 1 1 15 1 3 0
0 3 0 1 10 2 2 2 2 8 1 1 1 10 2 2 2 2 8 0 1 10 2 2 2 2 2 2 8 1 10 2 2 2 2 8 0 1 3 0
0 3 0 1 11 2 2 2 2 9 1 0 1 11 2 2 2 2 9 0 1 11 2 2 2 2 2 2 9 1 11 2 2 2 2 9 0 1 3 0
0 3 1 1 1 1 1 1 1 1 1 0 1 1 1 1 1 1 1 1 1 1 1 1 1 1 1 1 1 1 1 1 1 1 1 1 1 1 3 0
0 11 2 2 2 2 2 2 2 2 2 2 2 2 2 2 2 2 2 2 2 2 2 2 2 2 2 2 2 2 2 2 2 2 2 2 2 2 9 0
0 0 0 0 0 0 0 0 0 0 0 0 0 0 0 0 0 0 0 0 0 0 0 0 0 0 0 0 0 0 0 0 0 0 0 0 0 0 0 0
0 0 0 0 0 0 0 0 0 0 0 0 0 0 0 0 0 0 0 0 0 0 0 0 0 0 0 0 0 0 0 0 0 0 0 0 0 0 0 0
0 0 0 0 0 0 0 0 0 0 0 0 0 0 0 0 0 0 0 0 0 0 0 0 0 0 0 0 0 0 0 0 0 0 0 0 0 0 0 0